............
....XXXX....
...XXXXXX...
..XXXXXXXX..
..XXXXXXXX..
.XXXXXXXXXX.
.XXXXXXXXXX.
..XXXXXXXX..
..XXXXXXXX..
...XXXXXX...
....XXXX....
............
