XXXXXXXXXXXX
XXXXOOXXXXXX
XXXXXXXXXXXX
XXXXXXXXXXXX
XXXXXXOOXXXX
XXXXXXXXXXXX
XXXXXXXXXXXX
XXXXOOXXXXXX
XXXXXXXXXXXX
XXXXXXXXXXXX
XXXXXXOOXXXX
XXXXXXXXXXXX
