........
..XX....
.XX.....
........
....XX..
.....XX.
........
........
